16
16
16
2366
1260
1111001100111110
0001100111000011
0100110001010001
0100011101011101
0100000101101001
0111110110111011
0100100101101000
0110100100011101
0010001011010110
1110111101001010
0101100100001000
1100110111000111
1011101001101101
1010011111011001
1010100010000101
1110111110000111
------------------------------------
0000110111100001
1110011000111101
1010101110000110
1010000010110010
1011111010000110
1000001010100100
1011101010010111
1001011011100001
1101110100101101
0001000101110001
1010111011011111
1010001000101000
0100010110000010
1101100000010010
0100101101011010
1011010001001010
------------------------------------
1011100010011111
0100001000000010
0101110101100001
1000000000101110
0100000100110000
1011101010000111
0000100101111000
0110100100010110
0100001000101010
0010011000001110
1011000110100000
0101110000100101
1011011010111011
0101001110101101
0011000100100101
1000010001101101
------------------------------------
1110011101001000
1011110111110101
1000000000011111
0111110111010001
0100010101001111
0100010101111000
1100010110000011
1010101011011101
1011011101010101
1101100111010001
0100111000010111
0101001111011100
1100110001000101
1011000101010010
1100111011010010
0111101110110011
------------------------------------
1010001010111111
0100100000000000
1100110111100100
1010000000101000
1001001100001010
0001100011010001
0000110100011101
0110000101000000
0100110000101011
0010010010101110
1010100110101000
1000100001000001
1000001010011001
0010011110110100
0100100000001110
1001010000100000
------------------------------------
1101110111010000
0001011001101111
0011001001011001
0000101110010111
0001110011110100
1110011100000110
1011001011100010
1001111010111110
1000000110000001
1111001101110101
0101001011010101
1011011000110110
0110110111101010
1101100000000011
1011011101110001
1110110111011111
------------------------------------
0001001100001101
1110100000110000
1010110000000010
1001010001100100
1110001100001001
0001100010001011
1100110100011100
0000000101000001
0111100001111110
0000110010000010
0010010100010010
0001001101101001
0100100000011101
0001011110101000
1100100010001000
0001101100100001
------------------------------------
1110101011110111
0101011101011010
0101000001101110
1001011100101010
0011010101101000
1000010111000010
1011101001010101
0110110111000101
1101000100000001
1000011010111001
0111101011101101
1100110010000111
1011011110101000
1110100001110111
0001000011011101
1111010010110110
------------------------------------
0000110100101000
1011000010101001
0010111110010001
0110100010011001
0100101001000111
0111101010111100
0000001010100011
0001010000111010
0100110111001110
1011100100100000
1000001000010000
0010001101100000
1101100000100011
0000101101011000
1110110100100001
1001011100001001
------------------------------------
1111101111010111
1000111001010101
1001000001010110
1010000011000010
1011011100111000
1000010101000011
1100110101000100
0111101100000101
1000001001110001
1010011011010111
0101010110010101
1111010101010101
0000010110011101
1100011000100011
0010001011100110
0110000010111101
------------------------------------
0000010000110001
0101010010100010
0101000110001001
0101111100111100
0100100001100101
0010001011010101
0010101000101100
1000010010101010
0101100110001110
0111000100100100
0100101001100001
0000000000101110
1111100001100010
1000100111001101
1101100100011000
0101010110100011
------------------------------------
1011101101101110
1010101010011011
1010111001110101
1010000011000101
0110101110101011
1101111000111010
1011000111000011
1010111101110101
1011010000010001
1000110110010011
1001101011011110
1111011101000001
0000010110011101
0111011000101000
0010101011110111
1011011001011101
------------------------------------
1100110110001000
0001010001100101
0101000001001100
1101101100111001
1000000010000000
0011000111001100
0100111000110100
1010000010001100
0001100111101010
0110010100101100
0000100100100001
1010101000111111
0001100011000010
0100001010010111
0100000010010001
1100110100001010
------------------------------------
1001001011110111
1111101100000010
1010110110110010
0010011011000010
1011100101111110
1000111000100000
0111001100011011
0101110111010001
1100011000011111
1011101011000001
1110011000101110
0001010111000000
1110011100111010
1011100010101000
1000111101101110
1011000111000011
------------------------------------
0010111000010001
0101000001010101
0001001011011101
1101001000010001
1000000100100001
0111000110011111
1000000011100000
0010000000101111
0010100001100000
0100101001011110
0001100011010011
1001000010011101
0001100000000101
0000011100010101
0111000010010001
0101111000101101
------------------------------------
1111100111101110
1000011100101010
1110110000101010
0010100111100110
0110100100011101
1100111001110000
1010001100001111
1011110111011000
1101011010010001
0111010110000011
1010010101001100
1110010101100110
0100101110100010
1110110010110101
1001011010001110
1110101011111010
------------------------------------
