32
32
4
1150
3308
10111111001111111110111101011000
10010001111000000101100110001011
11000100010010100111011010101001
01011110110011100010001110111001
11010010000110111011000100000111
10000010111011001010010010111100
11011110001101101010011010100011
01110001111011001000110010111010
10000110101010011110100111001110
01010101100110010001101100010101
11110111000100100011001011100000
10010000011100101110010010111111
11001110110001110100110110001000
01011010000011001111001010110010
11010011110100001000011011010110
10110100011011110011101101101001
11101001101010011101010111001001
00001111011011101001100100011111
11001010010100100010010111100010
10111101111010010111110001001001
11100001000110110100011000011110
10001111011011010110001000010001
10101000110100111011101011110111
11101100011010101100110110001000
00110111100111000111101101100111
11011000110101101010110100011101
01110101100110110101010111110011
00001111011011010010000000001110
10011000001101010111100111011001
10110010010100110001011000110111
10100111101110101111101101101101
10111100100001111000011010111011
------------------------------------
11010000111000000101000001100111
01101110000111110010011000110101
00111011101101011001010101010110
10000001001000101101000101010010
00111001111011010100111000111000
01001100000000100101101101000011
00100001100001010101010100101101
00000101000100110111001101000100
11111010001100101000011000100001
10101000010001100111010111111001
00001010011001011100110100001111
01011011100011010001101101010000
00100000101110011011011001110111
10100001010100110000110100001101
00100010000101100111101100011011
01001101100100001100000001010110
00000110110101101011110100110101
01110000000100100110011011100000
00010111101111001101101000011100
10010000000001110000001110110111
00000110011100000011100101101001
01110001001000000100110111001111
00010110001111000100011000000000
00000011100101110011000001111111
11001000001000000100011001000000
10101110101010111001000010100010
10010000011000000111001000000000
11100000110100101101110011100001
01000111010101101010011100100110
01010101111010001110000110000001
01000010000001010000000010010010
11000000111110101111110111000010
------------------------------------
00001010100100111011111111010000
10010000111000001110101010001010
11000100010010100000101000101001
10110101010010100110011011100101
10001000000100001011000101001011
11100110100011101010010011011010
10110010011110110010010001010000
11011110110001000000110001011111
00000001100111001111100111000001
11010111011010011000100000001100
01010100100110000011001010110010
11000100011100110100010001101101
10000110010000000110101010001000
11111011011011101001001011100010
00001101001010010101000010100100
11100111011011010001111110101001
10111000000101010110001001001101
10001111110010010000100010010111
11010000010001011000110011100001
01101110011110000001100101000000
10111011100011110110001010010110
10000000101100011010001000010000
11010010110000101011000001011010
01111100010010001010111110010001
10000001110101111010100010011000
01110001000011000110111011101110
10101111010110011001001000110010
00011010100011100000001110011001
10110000101000011100000011001101
10101100000111000001000001010110
10110001111101011111111001110010
10011111000011000000001100001101
------------------------------------
01011111011111010110001010111101
11110101010101010000110101100111
00101001101001001111010111011001
01011110101111011001100100101110
01110011100101010110111110110100
10011000111100011001100000100101
01001101100000001010101110101111
01100001001110111011001010000001
00101110011000100000111010111110
00111000010110100111001101100011
10001011111001101101011011001101
10101001000011000101010110111011
01111001101101111001100101010010
00000110101010001110110101010111
11111010110001110010011101010100
00010000010000101110100000110111
01000111111010101001110111000010
01110000001010101101010101111000
00011111001110100101001100001101
10010001100001111101011011010110
11000110011100001010110110111011
01111001010111100101101100101001
10101111001010110101000111100111
10000010001111010101000000101100
01111110010100100101011101100111
11001010101100011101000100011001
01000000101001110000100111001011
11100101101000011101110001100110
10001110011111000011010100100011
01011011110000111110011100111001
11001100000010100000100110001101
01100010111110111111101011111011
------------------------------------
