10
10
10
9
16
0011111111
1101001000
1011000010
1110011110
0010100100
1010110101
0110011011
0101001000
1011110111
1101011101
------------------------------------
1100000000
0101010111
0000111101
0001100001
1101000011
1001010110
1001100101
1000110111
1110001000
0000000011
------------------------------------
1011111111
1010001000
1110100010
0000010010
0101010100
0110111001
0010000001
1011001000
0001001011
1111011010
------------------------------------
1100000101
0101110101
0001011011
1111001100
1010110111
1001000001
1101011110
0101010011
1100110101
1010101101
------------------------------------
0111111011
1010001010
1010100101
0000101011
0101100000
0110011110
0010100001
1010101101
0011001010
0001100110
------------------------------------
1001000000
1100010110
0100110100
0101010101
0101011100
0010000101
1000111110
1001010000
0000101011
1010011001
------------------------------------
1110111111
0011100001
1000001011
1011101010
1010100011
1101101101
0101010001
1101101111
1010110100
1111010111
------------------------------------
0001001001
1100010110
0010110000
1100001001
0111001000
0000101000
1010101100
1000010000
0111001011
1000111001
------------------------------------
1111110110
1000011011
1111001101
0001110101
0000010111
1010010101
0110010011
0100011100
0100000110
0001100000
------------------------------------
1000001101
0111110101
0000100010
1010001011
1111101000
1001001010
1001101110
1010100011
1010110001
1111011111
------------------------------------
