8
8
8
411
417
01111000
01001011
01011001
11010101
10100111
10111100
10100011
11100010
------------------------------------
10000111
10110101
10100110
00110010
01001000
01000011
01011100
00010110
------------------------------------
11001000
01010010
00011001
11001010
10101101
11110110
00001011
11101001
------------------------------------
10111101
10100110
11100011
00100001
11010001
00001101
11110000
10011111
------------------------------------
11000011
01001000
00001010
10011000
01110110
11000011
00001100
11100010
------------------------------------
00011110
11010101
10110101
11101101
00000011
10111100
10100111
00101001
------------------------------------
11100001
00000101
00001010
00010010
11011100
00000011
10010000
11011111
------------------------------------
10001011
11111010
10101011
10101101
10100101
01101001
01011111
01100000
------------------------------------
